__________
_____T____
___X_T____
__TT___X__
__TT_T____
__TT_TTT__
_XTT______
__________