TTTTTTTTTT
T____T___T
T____T___T
T_TT_____T
T_TT_T___T
T_TT_TTT_T
TXTT_____T
TTTTTTTTTT